R 1920 1080
NO ./textures/wall1.xpm
SO ./textures/wall2.xpm
WE ./textures/wall3.xpm
EA ./textures/wall4.xpm
S ./textures/wall4.xpm
F 220,100,0
C 225,30,0

11111
10001
1000011
10N0001
1111111